############D############
#.......................#
#.......................#
#..###......C......###..#
#.......................#
D.........C.R.C.........D
#.......................#
#..###......C......###..#
#.......................#
#.......................#
############D############