#########################
#.......................#
#.......................#
#..###......C......###..#
#.......................#
#.........C.R.C.........D
#.......................#
#..###......C......###..#
#.......................#
#.......................#
############D############