############D############
#.......................#
#.......................#
#..###......C......###..#
#.......................#
D...^.....C.R.C.....^...#
#.......................#
#..#G#......C......###..#
#......B................#
#.......................#
############D############