############D############
#.......................#
#..S.................S..#
#.SRS.......C.......SRS.#
#..S.......CCC.......S..#
D.........CCCCC.........D
#..S.......CCC.......S..#
#.SRS.......C.......SRS.#
#..S.................S..#
#.......................#
############D############