#########################
#.......................#
#.......................#
#..###......C......###..#
#.......................#
D.........C.R.C.........#
#.......................#
#..###......C......###..#
#.......................#
#.......................#
#########################