############D############
#.......................#
#.......................#
#..###......C......###..#
#.......................#
#.........C.R.C.........D
#.......................#
#..###......C......###..#
#.......................#
#.......................#
#########################