############D############
#.......................#
#.......................#
#.......................#
#.......................#
D.......................D
#.......................#
#.......................#
#.......................#
#.......................#
############D############