############D############
#.......................#
#..S.................S..#
#.SfS.......C.......StS.#
#..S.......CCC.......S..#
D.........CCCCC.........D
#..S.......CCC.......S..#
#.SbS.......C.......SeS.#
#..S.................S..#
#.......................#
############D############