############D############
#.......................#
#.......................#
#..###......C......###..#
#.......................#
#.........C.R.C.........#
#.......................#
#..###......C......###..#
#.......................#
#.......................#
#########################